#######################################################  #   ###/
###############################        #############       #####/
######################                                    ######/
#########       #       ###        #                     #######/
############# p                    #             ###############/
###########################           ##########################/
########################### ####################################/
########################### ####################################/
